]......................[
}...H..................{
}........@.............{
}<|||||||||||>.........{
}.................n....{
}..........T......u....{
}................()....{
}..........[]....\/....{
}..........{}..........{
}......()..............{
}......\/.C............{
}<|||>.................{
}........<||>..........{
}......................{
}......................{
}......................{
}......................{
}......................{