}......................{
)......................(
)......................(
)......................(
).................X....(
).........._...........(
)................@.....(
)......................(
)......................(
).H....@...............(
).........C............(
)=.....................(
)........<|>...........(
)......................(
)......................(
)......................(
)......................(
)......................(