]......................[
}......................{
}......................{
}......................{
}.................n....{
}..........T......u....{
}................()....{
}..........[]....\/....{
}..........{}..........{
}.H....()..............{
}......\/.C............{
}<|||>.................{
}........<||>..........{
}......................{
}......................{
}......................{
}......................{
}......................{