}......................{
)......................(
)......................(
)......................(
)......................(
).........._...X.......(
)......................(
)......................(
)......................(
).H....@...............(
).........C............(
)=.....................(
)........<|>...........(
)......................(
)......................(
)......................(
)......................(
)......................(