}......................{
)......................(
)......................(
)......................(
)......................(
).........._...X.......(
)......................(
)......................(
)......................(
)......@...............(
)........C.............(
)=.......-.............(
)......................(
)......................(
)......................(
)......................(
)......................(
)......................(