}......................{
)......................(
)......................(
)......................(
)......................(
).........._...X.......(
)......................(
)......................(
)......................(
).H....@...............(
)........C.............(
)=.....................(
)........<|>...........(
)......................(
)......................(
)......................(
)......................(
)......................(