]......................[
}......................{
}......................{
}......................{
}......................{
}...........C.....n....{
}.................u....{
}..........<|>...()....{
}................\/....{
}.........[]...........{
}.........{}...[]......{
}...H....J.....{}......{
}.......[].............{
}.......{}.............{
}......................{
}..<||||>..............{
}......................{
}......................{