}.......................
).......................
).......................
).......................
)......................{
)......................(
)......................(
)................X.....(
)........_.<|>...@.....(
)......................(
)......................(
)...H.........{}.......(
)........@....().......(
)......................(
).<||||>...............(
)......................(
)......................(
)......................(