}......................{
)......................(
)......................(
)......................(
)......................(
)......................(
)...........C.....X....(
)......................(
)........_.<|>...@.....(
)......................(
)......................(
)...H....J....{}.......(
)........@....().......(
)......................(
).<||||>...............(
)......................(
)......................(
)......................(