]......................[
}.................n....{
}.................u....{
}................()....{
}................\/....{
}......................{
}......................{
}....<||||>............{
}......................{
}......................{
}.............[]...C...{
}...H.........{}.......{
}........[]......<||>..{
}........{}............{
}.<||||>...............{
}......................{
}......................{
}......................{