}......................{
)..<|>.................(
)......................(
)......................(
)......................(
)......................(
)...........C.....X....(
)......................(
)........_.<|>...@.....(
)......................(
)......................(
)...H.........{}.......(
)........@....().......(
)......................(
).<||||>...............(
)......................(
)......................(
)......................(